49 11
0	178	178	0	178	178	0	0	0	0	0	0	0	178	0	0	0	0	0	0	0	0	202	201	200	0	0	0	0	0	0	0	0	195	0	0	0	0	0	0	0	0	0	0	0	0	0	0	0	
0	178	178	90	178	178	0	0	0	0	0	0	198	196	198	0	0	0	0	0	0	200	196	198	198	0	0	0	0	0	0	0	196	198	197	0	0	0	0	0	0	0	0	0	0	0	0	0	0	
0	178	178	89	178	178	0	0	0	0	0	0	197	196	197	0	0	0	0	0	0	201	199	196	197	0	0	0	0	0	0	0	198	199	198	0	0	0	0	0	0	0	0	0	0	0	0	0	0	
0	177	177	89	177	177	0	0	0	0	0	0	198	199	198	0	0	0	0	0	0	202	198	198	197	0	0	0	0	0	0	0	197	198	196	0	0	0	0	0	0	0	0	0	0	0	0	0	0	
0	177	177	89	177	177	0	0	0	0	0	0	0	0	0	0	0	0	0	0	0	0	0	0	0	0	0	0	0	0	0	0	0	0	0	0	0	0	0	0	0	0	0	0	0	0	0	0	0	
0	177	177	89	177	177	0	0	0	0	0	0	0	0	0	0	0	0	0	0	0	0	0	0	0	0	0	0	0	0	0	0	0	0	0	0	0	0	0	0	0	0	0	0	0	0	0	0	0	
0	176	176	89	176	176	0	0	0	204	0	0	0	0	0	0	90	189	90	191	90	193	90	0	90	193	90	191	90	189	90	0	0	0	0	0	0	204	0	0	0	176	176	176	176	176	0	0	0	
0	176	176	89	176	176	0	0	0	204	0	0	0	0	0	0	89	28	89	28	89	28	89	0	89	28	89	28	89	28	89	0	0	0	0	0	0	204	0	0	0	177	177	177	177	177	0	0	0	
0	176	176	89	176	176	0	63	18	204	18	63	0	195	0	0	89	0	89	0	89	0	89	126	89	0	89	0	89	0	89	0	0	195	0	63	18	204	18	63	0	178	178	178	178	178	0	187	0	
83	83	83	83	83	83	83	83	96	96	96	83	83	83	83	83	83	83	83	83	83	83	83	83	83	83	83	83	83	83	83	83	83	83	83	83	96	96	96	83	83	83	83	83	83	83	83	83	83	
66	66	66	66	66	66	66	66	94	94	94	66	66	66	66	66	66	66	66	66	66	66	66	66	66	66	66	66	66	66	66	66	66	66	66	66	94	94	94	66	66	66	66	66	66	66	66	66	66	
0
23 2
17 4 ;0;5;false;[#[7;5];8;5];;[#[6;5];7;5];;[#[5;5];6;5];;[#[8;5];5;5];;[0;8;5]
19 4 ;0;5;false;[#[5;4];6;4];;[#[4;4];5;4];;[#[3;4];4;4];;[#[6;4];3;4];;[0;6;4]
21 4 ;0;5;false;[#[3;3];4;3];;[#[2;3];3;3];;[#[1;3];2;3];;[#[4;3];1;3];;[0;4;3]
25 4 ;0;5;false;[#[-3;3];-3;2];;[#[-3;4];-3;3];;[#[-3;5];-3;4];;[#[-3;2];-3;5];;[0;-3;2]
27 4 ;0;5;false;[#[-4;3];-4;2];;[#[-4;4];-4;3];;[#[-4;5];-4;4];;[#[-4;2];-4;5];;[0;-4;2]
29 4 ;0;5;false;[#[-5;3];-5;2];;[#[-5;4];-5;3];;[#[-5;5];-5;4];;[#[-5;2];-5;5];;[0;-5;2]
13 2 ;9;4;false;[#[-1;7];9;7];[#[0;7];10;7];[#[1;7];11;7];[#[-1;6];9;6];[#[0;6];10;6];[#[1;6];11;6];[#[-1;5];9;5];[#[0;5];10;5];[#[1;5];11;5];[18;-4;0];;[0;-4;1];;[0;-4;2];;[194;0;0]
33 2 ;9;4;false;[#[-1;7];-11;7];[#[0;7];-10;7];[#[1;7];-9;7];[#[-1;6];-11;6];[#[0;6];-10;6];[#[1;6];-9;6];[#[-1;5];-11;5];[#[0;5];-10;5];[#[1;5];-9;5];[18;4;0];;[0;4;1];;[0;4;2];;[194;0;0]
23 2 Jump on the buttons to rotate rows / columns of the cube, and try to match the goals. Jump on a yellow button when they match!;0;500
