34 11
0	0	0	0	0	0	0	0	0	0	0	0	0	0	0	0	0	0	0	0	0	0	0	0	0	0	0	0	0	0	0	176	0	0	
68	83	83	83	70	0	0	0	0	0	0	0	0	0	0	0	0	0	68	83	83	83	70	0	0	0	0	0	0	0	177	177	177	0	
0	0	0	0	0	0	68	70	0	0	0	0	0	0	0	68	70	0	0	0	0	0	0	0	0	0	0	0	0	178	178	178	178	178	
0	0	0	0	0	0	0	0	0	68	83	83	83	70	0	0	0	0	0	0	0	0	0	0	0	0	0	0	0	68	83	83	83	70	
0	0	0	0	0	0	68	70	0	0	0	0	0	0	0	68	70	0	0	193	0	195	0	0	68	83	83	70	0	0	0	0	0	0	
68	83	83	83	70	0	0	0	0	0	0	0	0	0	0	0	0	0	68	83	83	83	70	0	0	0	0	0	0	0	0	0	0	0	
0	0	0	0	0	0	68	70	0	193	0	90	0	195	0	68	70	0	0	0	0	0	0	0	0	0	0	0	0	0	0	0	0	0	
0	0	0	0	0	0	0	0	0	68	83	89	83	70	0	0	0	0	0	0	0	0	0	0	0	0	0	0	0	0	0	0	0	0	
0	0	0	0	0	0	0	0	0	0	0	89	0	0	0	0	0	0	0	0	0	0	0	0	0	0	0	0	0	0	0	0	0	0	
0	0	0	0	0	0	0	0	0	0	0	89	0	0	0	0	0	0	0	0	0	0	0	0	0	0	0	0	0	0	0	0	0	0	
83	83	83	83	83	83	83	83	83	83	83	83	83	83	83	83	83	83	83	83	83	83	83	83	83	83	83	83	83	83	83	83	83	83	
0
10 1
