16 5	
0	0	0	0	0	0	0	0	0	0	0	0	0	0	0	0
0	0	0	0	0	0	0	0	0	0	0	0	0	0	0	0
0	0	0	0	0	0	0	0	0	0	0	0	0	0	0	0
0	0	0	0	191	0	0	0	193	0	0	0	0	0	0	0
83	83	83	83	83	83	83	83	83	83	83	83	83	83	83	83	
0
2 1
8 1 ;0;1;false;[0;-2;3]
4 1 ;0;1;false;[151;2;3]
