12 9
0	0	0	0	0	0	0	0	0	0	0	3	
0	0	0	0	0	0	0	0	0	90	20	20	
0	0	0	0	0	0	0	0	0	89	0	0	
0	0	0	0	0	0	0	0	0	89	0	3	
0	0	0	0	0	0	0	0	0	89	20	20	
0	0	0	0	0	0	0	0	0	89	0	0	
187	0	0	0	0	0	0	0	0	89	0	3	
83	83	83	83	83	83	83	83	83	83	83	83	
66	66	66	66	66	66	66	66	66	66	66	66	
0
7 2
11 2 ;0;1;false;[176;-1;0]
11 5 ;0;1;false;[177;-1;0]
11 8 ;0;1;false;[178;-1;0]
