18 10
0	0	0	0	20	20	20	20	20	20	20	20	20	20	20	20	20	0	
0	0	0	0	20	20	20	20	20	20	20	20	20	20	20	178	20	0	
0	0	0	0	0	20	20	20	20	20	20	0	0	0	20	178	20	0	
0	0	0	90	0	0	0	2	0	0	0	0	0	0	0	178	20	0	
0	0	0	89	20	20	20	20	20	20	20	20	0	20	20	20	20	0	
0	0	0	89	20	20	20	0	0	0	0	0	0	20	20	20	20	0	
0	0	0	89	20	20	20	0	0	0	0	0	0	20	20	20	20	20	
0	0	0	89	20	20	20	20	20	20	20	20	90	178	178	178	20	0	
0	0	0	89	20	20	20	20	20	20	20	20	89	178	178	178	20	0	
83	83	83	83	83	83	83	83	83	83	83	83	83	83	83	83	83	0	
0
1 1
