99 16
0	0	0	0	0	0	0	0	0	0	0	0	0	0	0	0	0	0	151	151	151	151	151	151	151	151	151	151	151	151	151	151	151	151	151	151	151	151	151	151	151	151	151	151	151	151	151	151	151	151	151	151	151	151	151	151	151	151	151	151	151	151	151	151	151	151	151	151	151	151	151	151	151	151	151	151	151	151	151	151	151	151	151	151	151	151	151	151	151	151	151	151	151	151	151	151	151	151	151	
0	0	0	0	0	0	0	0	0	0	0	0	0	0	0	0	0	0	151	151	151	151	151	151	151	151	151	151	151	151	177	177	0	0	0	0	0	151	151	151	0	0	0	0	0	0	0	0	0	151	178	178	178	178	151	151	151	151	151	151	151	151	151	151	151	151	151	151	151	151	151	151	151	151	151	151	151	151	151	151	151	151	151	151	151	151	151	151	151	151	151	151	151	151	151	151	151	151	151	
0	0	0	0	0	0	0	0	0	0	0	0	0	0	0	0	0	0	151	151	178	178	178	178	178	178	0	0	151	151	177	177	0	172	0	126	0	151	151	151	0	0	126	174	0	0	0	0	97	151	175	177	177	177	151	151	151	151	151	151	151	151	151	151	151	151	151	151	151	151	151	151	151	151	151	151	151	151	151	151	151	151	151	151	151	151	151	151	151	151	151	151	151	151	151	151	151	151	151	
0	0	0	0	0	0	0	0	0	0	0	0	0	0	0	0	0	0	151	151	178	178	178	178	178	178	0	0	151	151	151	151	151	151	151	151	90	151	151	151	90	151	151	151	151	151	90	151	90	151	151	177	176	176	151	0	0	0	0	0	0	0	0	0	0	0	0	0	0	0	0	0	0	0	0	151	151	151	151	151	151	151	151	151	151	151	151	151	151	151	151	151	151	151	151	151	151	151	151	
0	0	0	0	0	0	0	0	0	0	0	0	0	0	0	0	0	0	151	151	90	151	151	151	151	151	0	0	151	151	0	0	0	0	0	0	89	151	151	151	89	151	177	177	151	172	89	151	89	151	151	151	176	98	151	0	0	0	0	0	0	0	0	0	0	0	0	0	0	0	0	0	0	0	0	151	151	151	151	151	151	151	151	151	151	151	151	151	151	151	151	151	151	151	151	151	151	151	151	
0	0	0	0	0	0	0	0	0	0	0	0	0	0	0	0	0	0	151	151	89	177	177	177	177	151	0	0	151	151	0	0	176	176	176	176	89	151	151	151	89	151	177	177	151	151	151	151	89	151	151	151	151	90	151	0	0	0	0	0	0	0	0	0	0	0	0	0	2	0	0	151	151	0	0	151	151	151	151	151	151	151	151	151	151	151	151	151	151	151	151	151	151	151	151	151	151	151	151	
0	0	0	0	0	0	0	0	0	0	0	0	0	90	151	0	0	0	151	151	89	177	177	177	177	151	0	0	151	151	0	90	151	151	151	151	151	151	151	151	89	151	90	90	151	0	0	0	89	0	0	0	0	89	151	0	0	0	0	0	0	0	0	0	0	0	0	0	2	0	2	151	151	0	0	0	0	0	0	0	0	0	0	0	0	0	0	0	0	0	0	0	0	0	0	0	0	0	0	
0	0	0	0	0	0	0	0	0	0	0	0	0	89	151	0	0	0	151	151	151	151	151	151	90	151	0	0	151	151	0	89	151	151	151	151	151	151	151	151	89	151	89	89	100	0	173	0	89	0	0	0	0	89	151	0	0	0	0	0	0	0	0	0	0	0	0	0	2	2	0	151	151	0	0	0	0	0	0	0	0	0	0	0	0	0	0	0	0	0	0	0	0	0	0	0	0	0	0	
0	0	0	0	0	0	0	0	0	0	0	0	0	89	151	0	0	0	151	0	0	176	176	176	89	151	0	0	151	151	0	89	151	0	0	0	0	0	0	0	89	151	89	89	151	151	151	151	151	151	151	151	151	151	151	0	0	0	0	0	0	126	0	195	0	0	2	0	2	0	2	151	151	0	0	0	0	0	0	0	0	0	0	3	0	0	0	0	0	0	0	0	0	0	0	0	178	178	178	
0	0	0	0	0	0	0	0	151	0	0	0	0	89	151	0	0	0	151	0	0	176	176	176	89	151	0	0	0	0	0	89	151	0	0	0	0	0	0	0	89	151	89	89	0	0	151	0	0	178	178	178	0	0	0	0	0	0	0	0	151	151	151	151	151	151	151	151	151	151	151	151	151	0	0	0	0	0	0	0	0	0	0	0	0	0	0	0	0	0	0	0	0	0	0	0	177	177	177	
0	0	126	0	0	126	0	151	151	151	0	126	0	89	151	0	126	0	0	0	126	176	176	176	89	151	126	0	0	126	0	89	97	0	0	0	126	0	0	0	89	151	89	89	0	0	99	0	0	178	178	178	0	0	126	0	2	0	0	0	151	151	151	151	151	151	151	151	151	151	151	151	151	126	0	195	0	0	0	0	0	0	0	0	0	0	0	0	0	0	0	0	0	126	0	0	176	187	176	
83	83	83	83	83	83	83	83	83	83	83	83	83	83	83	83	83	83	83	83	83	83	83	83	83	83	83	83	83	83	83	83	83	83	83	83	83	83	83	83	83	83	83	83	83	83	83	83	83	83	83	83	83	83	83	83	83	83	83	83	83	83	83	83	83	83	83	83	83	83	83	83	83	83	83	83	16	16	16	16	0	0	0	0	0	0	0	0	0	0	0	83	83	83	83	83	83	83	83	
66	66	66	66	66	66	66	66	66	66	66	66	66	66	66	66	66	66	66	66	66	66	66	66	66	66	66	66	66	66	66	66	66	66	66	66	66	66	66	66	66	66	66	66	66	66	66	66	66	66	66	66	66	66	66	66	66	66	66	66	66	66	66	66	66	66	66	66	66	66	66	66	66	66	66	66	62	0	0	0	0	0	0	0	0	0	0	0	0	0	0	66	66	66	66	66	66	66	66	
66	66	66	66	66	66	66	66	66	66	66	66	66	66	66	66	66	66	66	66	66	66	66	66	66	66	66	66	66	66	66	66	66	66	66	66	66	66	66	66	66	66	66	66	66	66	66	66	66	66	66	66	66	66	66	66	66	66	66	66	66	66	66	66	66	66	66	66	66	66	66	66	66	66	66	66	61	0	0	0	0	0	0	0	0	0	0	0	0	0	0	66	66	66	66	66	66	66	66	
66	66	66	66	66	66	66	66	66	66	66	66	66	66	66	66	66	66	66	66	66	66	66	66	66	66	66	66	66	66	66	66	66	66	66	66	66	66	66	66	66	66	66	66	66	66	66	66	66	66	66	66	66	66	66	66	66	66	66	66	66	66	66	66	66	66	66	66	66	66	66	66	66	66	66	66	83	83	83	83	83	83	83	83	83	83	83	83	83	83	83	66	66	66	66	66	66	66	66	
66	66	66	66	66	66	66	66	66	66	66	66	66	66	66	66	66	66	66	66	66	66	66	66	66	66	66	66	66	66	66	66	66	66	66	66	66	66	66	66	66	66	66	66	66	66	66	66	66	66	66	66	66	66	66	66	66	66	66	66	66	66	66	66	66	66	66	66	66	66	66	66	66	66	66	66	66	66	66	66	66	66	66	66	66	66	66	66	66	66	66	66	66	66	66	66	66	66	66	
0
1 5
61 7 Now for something more interesting. If you mess up, just step on the button to reset!
63 7 ;0;42;false;[0;1;0];;[0;1;1;];;[0;1;2];;[0;1;3];;[0;1;4];;[0;1;5];;[0;2;0];;[0;2;1;];;[0;2;2];;[0;2;3];;[0;2;4];;[0;2;5];;[2;3;0];;[0;3;1;];;[0;3;2];;[0;3;3];;[0;3;4];;[0;3;5];;[0;4;0];;[0;4;1;];;[0;4;2];;[0;4;3];;[0;4;4];;[0;4;5];;[2;5;0];;[2;5;1;];;[2;5;2];;[2;5;3];;[0;5;4];;[0;5;5];;[0;6;0];;[2;6;1;];;[0;6;2];;[0;6;3];;[0;6;4];;[0;6;5];;[2;7;0];;[0;7;1;];;[2;7;2];;[0;7;3];;[0;7;4];;[0;7;5]
83 7 ;0;30;true;[176;-7;-2];;[176;-7;-1];;[176;-6;-2];;[176;-6;-1];;[177;-5;-2];;[177;-5;-1];;[177;-4;-2];;[177;-4;-1];;[177;-3;-2];;[177;-3;-1];;[178;-2;-2];;[178;-2;-1];;[178;-1;-2];;[178;-1;-1];;[176;7;-2];;[176;7;-1];;[176;6;-2];;[176;6;-1];;[177;5;-2];;[177;5;-1];;[177;4;-2];;[177;4;-1];;[177;3;-2];;[177;3;-1];;[178;2;-2];;[178;2;-1];;[178;1;-2];;[178;1;-1];;[178;0;-2];;[178;0;-1]
29 5 What's this? A lock? Maybe it needs a key... Look around for one!
36 5 You got through! Now for something more challenging...
2 5 Welcome! Press A to move left or D to move right.
93 5 So walk over the flag to end the tutorial, and go solve some puzzles!!
76 4 ;1;5;false;[0;-1;0];[#[0;0];-1;0;$];;[#[1;0];0;0;$];;[#[2;0];1;0;$];;[#[3;0];2;0;$];;[0;3;0]
76 2 ;-2;3
42 13 Ooh, a red key! I wonder what it's for...
11 5 Press W while on a ladder to climb up!
26 5 Did you see your score go up?
35 13 There it is! Pick it up, go back and see if it works!
16 5 Can't get through? Press S to duck!
54 5 Good job! Keys are fun, but what else can we do?
79 4 ;1;5;false;[0;1;0];[#[0;0];1;0;$];;[#[-1;0];0;0;$];;[#[-2;0];-1;0;$];;[#[-3;0];-2;0;$];;[0;-3;0]
75 5 ;0;15;false;[16;1;-1;[;1;5;false;[0;-1;0];[#[0;0];-1;0;$];;[#[1;0];0;0;$];;[#[2;0];1;0;$];;[#[3;0];2;0;$];;[0;3;0]]];;[16;2;-1];;[16;3;-1];;[16;4;-1;[;1;5;false;[0;1;0];[#[0;0];1;0;$];;[#[-1;0];0;0;$];;[#[-2;0];-1;0;$];;[#[-3;0];-2;0;$];;[0;-3;0]]];;[0;5;-1];;[0;6;-1];;[0;7;-1];;[0;8;-1];;[0;9;-1];;[0;10;-1];;[0;11;-1];;[0;12;-1];;[0;13;-1];;[0;14;-1];;[0;15;-1]]
20 5 Try collecting some coins, see what happens!
73 5 Cool! There are lots of possibilities...
5 5 Press Space to jump over obstacles!
